#####################
#...................#
#...#...#...#...#####
#...#...#...#.......#
#...#.####.##...#####
#...........#.......#
#...#####...#...#####
#.......#...#.......#
#...#####...####.####
#.......#...........#
#####################