#########
#.......#
#.#.#####
#...#...#
#.#####.#
#.......#
#.#####.#
#.#.....#
#########